11100000000000
11100000000000
11100000000000
12121212121212
21212121212121
12121212121212
21212121212121
12121212121212
21212121212121
00000000000222
00000000000292
00000000000222