111000000000000
111111111111151
111000030000000
000000030000000
000000030000000
000000030000000
000000030000000
000000033333370
000000000000000
000000000000000
080000000000000
024444444440000
024444444440000
060000000034490
000000000000000