1110000000161
1122111111111
1110000000111
0300000000030
0300000000030
0300000000030
0300000000030
0300000000030
0300000000131
0300000000191
0600000000111