0000001111000
0011101911000
0011101111111
0011100111001
0001000110001
0001000101111
0001000001000
0011100001000
0011111111100
0011100000000
0000000000000