1110000000111
1122111111111
1110000000111
0000000000010
0000000000010
0000000000010
0071111111110
0000000000000
0000000000181
0000000000121
0000000000121
0000000000191