111000000000191
111000000000111
111000003443333
111000003000000
171000003000000
000000003000000
000000003000000
000000003000000
000000533000000
000000004000000
000000003000000
006111111111111
000000000000001
000000000000001
000000000000001