0000000000090
0111001110110
0222001210220
0212001011210
0010021010220
0010011010210
0010010010220
0010021110210
0010111000000
0012111000220
0011121111110