1110000000111
1111111111171
1110000000111
0000000000000
0000000000000
0000000000000
0000000000000
0000000000000
0000000000111
8111111111119
0000000000111