1110000000111
1125111111161
1110000000111
0300000000010
0300000000010
0300000000010
0300000000010
0300000000010
0300000000111
0300000000191
0333333433111