1110000000000
1911111122000
1110000111000
0000000033000
0111000033000
1111333333000
5111000000000
0001110111000
0000111111000
0000000111000
0000000000000