1110000000111
1111111111111
1110000000111
0000000000010
0000000000010
0000000000010
0011111111110
0010000000000
0010000000111
0011111111191
0000000000111